111111111111111111111111111111111111111111111111111111111111111111111111111111111111111111111111
100000000000000000000000000000000000000000000000000000000000000000000000000000000000000000000001
100000000000000000000000000000000000000000000000000000000000C00000000000000000000000000000000001
10000000000000000000000000000000000000000000000000000000000BBB0000000000000000000000000000000001
10000000000000000000000000000000000000000E0000000000000000000000000000000000000000000F0000000001
10000000000000000000000000000000000000000000000000M000000000000000000C00000000000000000000000001
1000000000000000000000M000000000000000M000000000000000000000000000000000000000000F00000000000001
1000000000000000000C00F0000000000000000C000000000C0000000000000F000C00M0000000001100000000000001
100000000000000000000000000000000000000000000F000000000F00000FM00000000000000C001100000000000001
1000000000000000000000000000C000C000000000010000000000000000000000000000000F00001111000000000001
100000000000000000CCC00000000BBB0000000001010000C0000000000000000F00000000000M001111000000000001
100000000000000000000000000000000000000101010000001100N0000H000000000011000000001111110000000001
10000000000000000NN000011101NNNNNN100101010100N1111100000000000000001100000N000011111100G0000001
111111111111111111111111111111111111010101010011111111SS00000000001111001SS100001111111111111111
